jkf: rsf fhm hcr
slh: jxs mbc nqk
jvg: jvt qsr
jrp: hfr ksn frs pxt pdn
cpx: pnf lxf hxp dxz
kcn: hhn
ltc: dhc
hcx: dtg dpm
rst: cxb xch kdf xsv
jlq: mcp
ntg: fkn qdx cpd
vgv: vzh jtk tfk
xgl: fvj tsr
xpv: ckg zmm lnc rgh vdq nvr
flz: pxx hms
nmq: cxz sld
hrz: mtb gcj fkk sgb
kcr: gdj lll gxp tfp
vmt: cbn
vst: bxl fkr ksc
vmv: mzb tkq bzr
jkz: qjj vnz zfx tfp lvj
hcz: czf
tpq: vkh qqm grq vct
fkk: qzf rrf mbc bjr
tvs: dcg ccz
lbb: pxh msf znx zmm
mtd: tgd
qmj: psp lsz svl mxd
xnh: qnk cqz
pfm: kcj fxq lfn
brr: dml
skt: nlz rbg
knv: nnq lzz knm rxb
fhp: rvk
nzp: mfj glv
fzt: hfc
dps: cdr
bmb: vnk dtc vcb
bpq: tgr
qld: xch ztf
fsm: vqr tsg lbf cvd
ptp: pzq
mhd: vdq bnx
nhc: pkt
mjz: mpv zgb
bnt: xln cjf gbh bjq zlh
rcf: nln bgn
pbb: nhc zdf
slp: qjj plf
nkp: mmj qts lnb szh ndg qcm xbp
jzp: smk vnz
bxb: hvt
blz: brp spp jqg mnl hfp
pgb: zjj hzr lbq
psb: rnd hjk jfx
fkj: zjb mnr
zbj: fzz qpt sxl mxd
qgf: pph
mrx: rxt ktq bxz
tlx: vrn tgm jqr dpl kld lfj
bgk: nmq xjr dbk
ldq: ztf bml gqh
msj: nvs
fmf: smk bzn
mnv: csz zng zzz qpx
xmt: qmg rvz pfs tqh lgn
cdf: zqz ppj tfc
zsf: kph rpp gxd
hpt: czs scc mjg
jks: cfr xnp
qts: trs clt
mmv: dft gpx rzl
psz: sdb
hnx: bsx plg
cpn: hhn
gzh: dzc qvf
zhq: lbf rqb cmd
rhh: ztz zqz vhs mlr
fcn: smk qxc ccj
mrn: mbh
jxm: qpl pjq pbc dqc
fjq: pqm lbg fpj
fpj: jzz
fmg: pnc
pqg: rvg qzh hfp
ckr: lmn
cvp: fpj msj nsr pnf bqb
mgn: tvq shf
phn: mjg vds ckz lbb
nlj: dxs slm lbf tjh
fbs: qnq rqb dpl lfd znz
ljn: nvh hdk lgb cdf xxx
zfh: jtd cmd
qxz: xjd kjq tjh zft
zfj: ghp zpd
dxv: rql kjm sjf ckr
szb: sgb ppt nqp
dsb: xch htd crq hbm
zxh: rxq ptp bcj jvt
mqz: rrt
jpd: sfb mcg kqn
bnv: kxs rgh zgr rpt ckg mpf
jrc: tnh lhh
jrn: dxb vrg
hgj: xjt dpc gpx qcm
lpp: xxx zng tsm pxh
zqr: srq dkl
fcx: vgl bzd czx
jcj: krq jkv hgl tkk
clt: mck shf
spf: pnx nrc vmv pfm qkg fxg
lhn: pqg jpd ppt cmb
rjv: nsj nzp bgq kkz
mts: lbb vpp gsz
zfn: bmh zfj gdh
tmv: drm hjk flf
nvh: tfk nvr
fnf: xkh xbb nbd hrk
tsc: gpg cmg lsj rhf
mch: mcp lzd hht
gxd: ndm mvb csz
kjf: hqm kgc
lfn: cfr qpt
mcv: fsf jnm lrj bkc vsv pvj
txt: cgq vlk krn
xqc: fmc jvt sds
njr: jzq bnl rtk
cqq: kfr gdk jkm
tzx: dzp snz vjg
qvz: ntg qmg dkl vjp
tnx: gth rzg mnv
slk: mnl cpl mvb
mvf: zqv
brj: hcz xfp fxm mlp
mzl: dpc ksc bjq jzl
dbf: mfx djl mrx
nml: rnh zgn lpb sgt
bhd: kxd gmh
zxj: fkn trf
hvc: mxd
lkk: jgr sds gcr
hlp: bnl nkp xdd kmn
hfp: zts hzb
mkx: pxz vrk lsz vlf pfz
hnb: dsr gfr
tjh: bkl dnm
rrs: grv
rmx: tgg zbv gfz
klq: cnh hgr zcc
cjk: ktd gqn
dmz: nbd smk
psd: vvg lxf tgm
jhs: hfn
pcs: lxk shl njk nkp
tgg: dxs
hft: rjp pfs
njc: kkz njh fhp rtj
fkn: gfz hbm
jqx: qmf qqh gkd bzf
kxf: kqp xqk rcp
pnf: bss mkf
nsk: fmg tgr
cbn: pnx
bjg: zfx zls
xqx: ccc tbk pnx ftf
xpl: hbm lxx
dtp: ksn vqp fxv nbd
dnl: nhv nrx vrt
fgq: tgg vmt cqz jlk
tqs: drp
jbs: qbv mcs lvr
dlr: xgd lkp bnx nfx ngx nng stn
ndf: nlz zjb jqf
rlv: rrt qxk
zkj: pmh rtl dzj zhc
dxd: vbg pjk zqv bcf
vvq: gbh xsm vms
fqn: dvc kvz hmn mcp vnh
kjl: njk czf vtq
qjj: dbx ckf
nbd: bzd
tkg: ddc mcn rsk tqs
hvr: cfr qbj
sdk: flf ppt xtz bbz
hmn: tnh
blb: stj mxx mqz szr hvv
hfc: ghp
plf: rtj
ndm: zng cdf
fbk: pfm gpq hxp nhc
zzs: pjq
djb: tqs
mdq: kjz prh
tlt: pmk
nvn: zjj
kpp: bzn pxx
qgn: bjv mmj bfs ntf
dnj: ccz qcs rhx jfn zfk
xdd: cdk psn bnl
rft: lvs bhc jzd
lnc: ncb
lgn: hvt
ndc: vhl
ksn: zls jzh
mck: gzg jzp rjj
nsp: czr fpj dxq nsr fmb lmn pjz ffk vnp
zth: fll fmg
clc: gzk xjd rss cxj
cgq: lcg pzc cjp jpv
qbv: frt jvp mfj
xls: mzm
pgj: zqz rgh zml
xks: gfr
zkg: cdr jrr dps lhh
jkj: zfk hzr csj
vlc: btg ljk zgq
dgn: nvh vfj mqz gfl
zks: svl xdb gfz drl
rgl: qqb pmn
sfd: vrt nrf skt
ktp: xmv kct
rqm: zql mpl
dmb: bpf vqr pmk fcf
mjn: qrs czx
bfg: kph fhp dlk rtk
lfq: prh txv pbg
czs: njh
fqs: gff grd cql rpt
kmc: lpb gkt jtk
jhf: ftn rrf nml bzn
hjb: kdc rzf srn
rxq: xmv
tkk: grv
nrx: ngb dfh
tfv: mbh rgm xnh sxj nln
nzt: bml zxf ntz fzq
hnc: zhl hhn qlm csb
rnq: cqz
dzd: jbs dpc fct sfc
kdl: hrb kjr nvn rms tnr mlc
mkj: jrr dzs nvp
nrc: gbj zbj pbc
fsz: nck tnh cpd tbk
nqv: tkq
bfj: jlq rsj
pcl: xkq sxq skt
bft: pzl bgq nfn sqc
stm: zdq ckf zkx gth
vjp: nnq qqm vqr rmx
gff: pnc hnb frs
zgb: zmd
zdh: mvb
vdx: gdb clr vqp jkm klf
dfg: zjc cln djt gzh
fkr: vdq
psn: nsk
csb: bbl ltz
gqn: bkl djr
xqq: mkg jks hqm hgg
ntj: qjg vlr qzh jnm
dtc: slj cdf
qzf: kmm blx
jcg: nkg nmc rcp lcq
kng: pmh rrr ccm hqm nkk zcv csj
tls: jnl qks qpl
gvn: fzt xhf qfg
fds: xhk dkl mkg
htd: hrp npt
rkf: gqk drm zsf czk
lbf: qjq
zxc: bjj djs zft ncx
xnf: snz
rht: jrc drl gbj vgf bjd
ggs: zgr qjv
hqd: vsj xpl xrj kvz
qkt: dbk
thg: hkz gkj lfd pkt
vkf: dlr rff plc pvx
qjv: fql
gcz: pqm ptd dtk
mvb: jhp
jjj: rfb crt zts scm
bfs: srr mhp nqp
dkc: msf kfh dgz cfl
tqr: smk
shl: zxq kvb zkx
dmk: nfp cfv fmf
mgh: csn pjq
dhr: vpp dzc crt
frp: hrb shh rvm lzc tkd
pgq: jgd dmx jcr tpz
lnf: zxf
dnq: qqh fkc dcg
pmh: zjj dfh
pfk: xdc vmt ftp hrd jtd
cbr: zsz dzj
hht: fxg ccz
cxz: pvk dhc kfp zvq
qzc: lcd xnf ppt
ftn: bjg
gdn: lft bss
ndb: tsr pvk nhn hqc dnm
zgr: kfr mxn
lkv: fds xfm bfj mkg
bcj: qxc mtm
vdv: cgg dxl jgr bjg xjt
gkj: rjp
nzd: tqm xbb
xrl: jlg vlf cbr
bnm: dxb fhm gmh sls
hrf: tgr ktf
cqj: jld qlm xsm
bzv: xmv jtg
jvt: ckz
srn: fzb tvq
vxd: ccz
ldj: dhn dds hds
npl: gsz scq snz zmn
cxv: mfx bfd sdz hzr
xlq: vxb dnm
szr: hzz
vlf: xcb lhh
jqg: mfj
pph: zvn
mfm: mgh txv fvn drl
rxb: xhx dqj
ffj: pxx nbd ndc bbl
kjb: vxl ftf qln cbd ttp chc
xbp: zqv
rtt: czf lfg nng rxq dzd jxc jjv
qdn: vlr
hgl: tnm qzj ddq qzs
bxz: mcp glq srq
rdq: fqc zls zvr clt
mxx: drp bjz
pbc: hmn
xhk: mrn zgx
qpx: pqn rdv lkp kfh
ccj: mcs gmr
zjg: snx ptd
cnc: sst vqp vpv kbx
bgv: lxl
dtb: jtg
cjz: lgk lqq zjg ktq hkz sxq
dzs: tcx kjm vnp
bsx: qnr cbn
lbt: rql gft
lkz: qkc zvq hrb hfn
vfs: xkm czx cpn tgh
rhx: rcf bbd kff
vvx: hfp dzc lgb fbm
fxf: jtg nsc btd pxh ftm
lxd: sdm fcf hrd cmd tgg bxb ztf
gdh: nvp
nrj: qrq
jgd: bnl pnk
psj: tfq zfh tsr lvs
znj: djl
mfl: tbg zjb kdf ddq
mfz: qvl spr zkh dtk
bvf: jbr vst mhd qgf
bff: dbx ghv rzl mtm
bxn: bzv pcz tvq rff
xvz: qnr zxf ldn sls
dzv: pcz smk
rtx: kxd lfz ztj jgg njx
ncd: tgd vlc slh hdd lnb
qzg: cmb pzr zmd nxj bqz
cxb: vkh gnh
qqb: tdd
xgn: lmm lck cgx jqx
ccc: dzg
htk: jzz
xkh: svg vhv
rxk: tmn zjb rsj jqr
qzm: ntf fvg vjt vzk mnv vbg
xpc: htk psp qqm xrl
vnj: nxj dzq mcn sxp hcz snz
zqg: nzc vfj cjf mcg
xrj: lkz qfg dmp
vbx: mxn mfj hfb stq
bpf: qpl jpv
hvv: mtb
zhv: tvz lxl mtm ntj
nls: kmd vxb
hxv: gdn pmk xsv hfc
cck: msr kxv msj
nvr: dhn
gfr: ksv pjk
hfv: mzb ccp qqh rqn
txf: ndz rjj djb nzp
xlr: bqb msb vct hfn
xxr: clr bfq ngx nxx
fgh: jrn lkz
lmn: qbj ngb
llq: hjk kdc nrn
rdp: lhh xqk tlx kpd
bss: czr nrj dml pqm
fvg: pnk
tfq: ghp kjq rkl
vsv: pxr rfb dgz
hfb: tvq sjs
tgp: dpm rpl frs vcb slk ggk
nhn: svt tbk frm
mgv: bzn
lcx: bnk cfv nzs pvl
dxs: dps rqb
kbh: pzl bgh dgn
mrr: jml hfb
xjr: nmq
bdj: tgr rrt mrr dpm
rvg: bpq vnz
lpb: mpf
gdb: znx npb kgh
lmm: tsg fkc htd
brh: bgn xdb jkv hxv
ppz: tqr nxz vmj msh kgh
ttj: jnl grv fds
sfb: zml dhn
ckp: kxp krq lgn bgn
nsr: tlc kcv
rcg: jfr pbb zjb gtz
scq: slj bcj
frm: dxb ccm
xrp: tfc jtg sds
qrt: rbg tkc qrh kff vcz jfr
vds: fql csz fzb svf
kdf: bgb
rcz: dxd rgr pnb vhs
vgb: zxq rfq hvg jtk
kxv: vrg
kzd: ftn zdh ckg mjn
rdn: nfx sfb
kbr: cbr hzr vlk lsz
vbf: kvv gcn
jrk: kmd nvp gcz gqn
pnb: rvk
csk: kcn mmv qvf
lzz: sjf
zrt: rqm pqx mxn kbh
vnl: gxp cgd dbx zgb
njk: fcx hrf crt xrp vnk
txd: kfr
xrx: lfg xks psn
lkf: kxx zng gkt
vcg: bgb lfn crq tbg
mfx: cxj
dqc: zgp xfx qnz kkf
pvj: slj
tpz: kfh bjz
sxj: fkj lhz pgb rbg
xxx: zjk jzp
vbp: vgm qrq mxd hbm
vqq: hcz dmx prx slp
rvm: trf
knm: jsc xvc hvx
fjr: sfg nls lnf rsj
dzp: frs
gsc: qnk nln vrn
bgq: kcn mtm qkd
kfr: mnd
stg: zzs xdc rtl xps mkg
kbq: nzc mrr bdj
qrv: svt vkv rgm ccm nhv
ndr: vfh thf stq
ckj: ghv
gjf: znf tzx fnp vzh
ftp: htd
dtg: vpg vqc
dxb: pmx dbk tbd
kvz: jfd qpl rtl
ddq: tlt fxq lgn
xjs: lsj qcl ckf
spr: zpd dzj
kkf: tnh pgl kmd
fcp: hvc
krm: ntz kpd mkj
zgg: hzb gvr llq xbb
jrj: ccc sxq lqq qxz
vcb: qxc
slm: krn
xvv: lpp gjq tvq pgj gxd
vbg: vdq zkx
dpx: nfp nnx ztz hpt cpn
btf: mnr lzz gqn tkk mch
qpl: jlk
qgd: bhf svr hrz pnc
zxv: gkj
zgl: hlh rpp dds nrd tmv srg
kxp: stg ndn
gpg: svf fbn rzg jxs gkt
szh: tqr
rms: dfh
svg: scn rdv
cjf: cql
ktk: vgf cjk rgq pbb jlb
clr: dcn rhk
vpg: vgg
fhj: jqr qzd dsb
rcm: fzt cxj htk rgl
mmc: rfb qxc
fqh: ssx dpc
kxs: jgr
bml: pxv nvp
pch: xkh psb vvq mts
ccm: hfc
ptc: hxp fkn sgq
vvb: cmg tgb vqc
pzr: nfx
fxv: sds
pzc: hvp gcn bbd pvk
fgt: dxz fzz rcr hcr
tqk: jhs bhd ghr ghp
rrr: xcb jxz jzd
xnp: rmp txv
scr: sqc hcx lml njr pdn
qsl: bxl
pxr: mck lcb bfq
kcv: qdx msj sfg kxp krm
rmp: cfr
jsc: hvt
scc: svr zmn qsr
bls: hdj hvc
kjr: mcp
prf: czx fgx qcm
pkb: nlz nvn fcp zxc
zzz: fll qdn hvq
tnr: lfz dzg pkf
gmn: qgf xgd ztz bjz tfc
mkk: rpt tsm fgx hfl
grd: bxl
fmb: knn vkh rbg bzp zqr
rqx: ldj lcb nxz hcx
hcr: ccz jqr
dfj: kff zfh hdj jsx
dlk: fhv
gbh: cpn mcg
crq: jzz
rdk: pvj rdn bnk vpg
prx: hnb szs
gpq: xjr
zcv: czr
cxj: dzg pxq
rls: jzz crq kvv
zlh: hms mls gth
nxz: cqq fbm
ncc: snx svh qxt tnr
bhf: mlr xfp rds
gsz: snm
prv: zsj bmh lfq qjq
cpl: fgg xqc mbl
mcs: jvp sdb pcq
zcm: fkl rls ttj dcg
btn: njf cxb fvj hzr
hfn: qzd
fnz: pzq mpv vbx
rhl: pxx zmn ncb svg
nnz: jlq kvv dfh
qxx: jkh zqr qmf bbj
plc: fhv
frx: lkk lxv hvf
tmg: ndz jqg znf tmf
jtg: zvn
csn: lcq pkf
bgh: fxv qcl snz
nkg: jkj kvv tkd
lgc: xnf
nfp: cgd gfm
tmf: mbl sbg
rgk: rff zbh csk tmv
dcg: kld
dft: hlh dlk
xcb: kjq gqn qpt
qhr: bmb xks cmp jtk
bcf: cfv
lvr: csz
npb: ftl thf
ksc: dcn kmm scm
xzz: gzz gfp bbj qld
sth: cpd
jqf: smb
bbj: vgf svh qkg
gjq: shl npb
lzg: gpg hfl prx rpt
ccg: bbz cqj zth lnc
gfh: kjz rrs tpq njf
khp: qpt vcz
kbx: qrs pxx
brv: zts psn bcf
vgs: cck jsx rvz qkt sth
cfk: jks lxf zsj
bgb: glq
shh: tbd cdr kdf
ffk: qqb dtk
brp: hnb zmc rnh
vms: qcm nfn bjr
jzs: fcp xjr rgq
stq: jjv
qmb: dbk gnv vfc
flf: lml njc
qtf: ltc npt hcp
tht: vrn qvl hqm
sdm: sfg qtf bgk
vnr: mdq mzh vxd rdg
gzk: zfn kcj gnv
hmq: zft fzz vsg rsf gqh mgh
kmd: gkd
ctk: bls gmz
kbc: mbh vrk gmz ncx
kfp: lrk svc
lcg: zjb
vgq: vld qbs
bxl: cfp
hhg: zgx jnl zxv xsv
stn: vpg xls rrf
ghr: qcs ftf qld dxv qrq njx
trb: kzd cdk fcn qzm
dpv: bbd rqn pfz skt
crs: tqs lnc qzh
ddv: qks rnq lvs zxj
jxz: gcn nln ccc
hxp: qmb
thf: zvn
lst: lxk kfr
lft: tbd vvv
nkk: nls fxg cck
frr: cxb
hfr: qxk djb hvv dcv nqp
stj: jcr ndg bgv
tqj: srg qjv
qnz: jqf pkf njx fhm
tnm: mqb tsr pvk
rzg: mpv zvn
zsz: gdn
plr: scr nsj jzl ckj xjt
qqm: zsj
qpd: rvk zqv
vtp: rmp sdg nnj bss
pxz: pbc mkf
lgq: zfj vxl plg lrq
qln: mkx rrs lzc
dnm: btn bqb
kvj: kjr ckr chc hdj
bhc: lhz srq dqj
cql: bzn
nqk: tmf qzf
zcc: svc gkj
rgr: psz gqk mxx
mzs: jgf lnf rcd krs
jld: ftl nrn gbh
fbm: hms tqj
jfn: lxf hdj
hkm: fjq ndn vkv dkl
kct: mgv qsl qbv
fxs: mgn gdk lgf mbc jkm
xlj: ndg kpz fvd rdn
lbq: svh slm vrg
kcj: cdr zfh
xkq: csn xhf
ngf: lqq bss prg jfd
xfd: pjg dtb hrf pdt
txk: qzd ckq pkt jzd fcb
vfc: glq
csc: czs mcg
lvs: rql
kpd: qzj
cmg: tbr hds djt fxm
tgr: vgg
ttc: ftf zzs bml tpv
tjl: mqz hzb vmk fkr
vsj: ftp lfz
xsj: fhv bpq ldj
ccp: dps mrn
hvg: mgv zfx sdb
fcb: sgj lrk dzj
pck: htd zdf gmh rxh
msc: bxb sld lhz gzz
cdn: fcp
rtm: btn nrj zxv nmc
rtj: vzb txd
lnb: rrt
nvs: hcp rqb
zng: zmc
shd: dxs dnz fzq jfd
kvb: trn gzg ckg
cxn: ckj xrx ksn cmb
vmj: mlp szh jzl
sjh: gvn rxd bpz rnq xqq
phz: pkh qxx svc fbv zgx
vmk: snm
chc: tkd nlj
spp: kkz cln
jzd: dpl rsj
pjz: rjb jfn smb
drq: jhs hcp dml sxl
nng: fxm
znz: lrq nqv xrj
lmx: rqb brr xvn jfl
vqp: rpl
ssx: ltn qvf
rzf: msf qdn pvl
xbh: dcv lpb gkt zqz
pkh: nhc nrx vgq
std: qjq mrn
xnc: mcv zrt nvr dtc
gth: rnh pnb
crv: nsj pgj fqc gcr
gsv: kcv fxq jkh qzj
mzh: kld
bmh: kld
qlj: ddc mdz fcx djb
fnb: ktp hjb lcd
msb: pfz cjp lxx
qzs: zcv mrn kpd
trf: sgj
ckc: cpl ndc jhp xrp
dxl: frx lcx clk
zmm: bzd
hrc: mvf xrn pnk
zds: vkh pgl
bkl: mnr svc
cmp: nzd zqh bnk
fbg: cxb hvt ndf rbg
gfp: rtl nmc
nzs: mhd bzv
ltz: tfc gpx
pzl: vlr
lgf: tgr mtm scc
mcm: qgd qzm hvq fgg
kbl: dmz mlq vqc
zjc: jvg xks qsl
kfh: vhl
jsx: qzj xpc
lxk: xln
nlg: lgk cdn tdd vlf
tbg: lcg qnk
bzf: kxd dvc xjd
ttp: jnl fzq hkz
rds: fll jqg
kph: vlr rfb ktf
cmh: pzq
sdg: pqm mnr nvp
ktd: nrf hqc lrk khq
vxl: npt gsc
lgb: hvq
cnh: qbj hrp psd hvp jgn
lhz: gcz
nct: prj dqj kgc hgd jfk
vjk: szr rvg srr qxc
sxq: hrp rcd
zgp: qbs ztf
jln: nrd crt kmn pjk
rnd: zgn lkf nrn
rps: pss ncb qlm fll
jpl: fxg bml
xrn: nxj mjn fbn
vlk: ncx tsg
vxb: tmn
kjq: vcz
jlx: slk dzp gzh pcz
jfq: mlr dvm qvf mzm
vct: cxz lzc
rzl: mjg
cfl: czs tqm fvd
vzl: lvs jbk xgl bgb
mhf: pdr jqf dzg bqb
rvz: khq srq
zmn: cln msf
hzr: djr
rxt: nhc nnj hzr
mtb: qzh vnk
bjq: jqk
btd: hvg fsf sxp
zql: njh ncb gzh
hzb: hvq
lhh: tvs rgm
cjq: dfh chp cvd fgh qkt khp
hkz: sgq
zsc: bzd xbp qzc
dtk: zbv
fhm: psp
sst: pzr bjr
msk: dmk gfl fnz hfp
djl: bmh tbd smz
bkc: sdj
tqm: rgh
rjb: zfh tcx qqh
lxv: lxk zth jcr
kdc: xrp gdk cln
dzq: vmk vgg
pjq: zjj
vzk: qgf szh zmn
zsj: gsc nqv hvp
fkl: pbm lvs vrt
jpf: lcq gkd zkh csh jfl
lll: xbt
csj: hcp xdb
qmf: bss hht
pqx: vmj bjg
cdv: zqz mxx tnx klf
vpd: fcs gmz qrh kjf
hjg: pfz jxz fbd prh
dsr: mtd kcn
mlc: rbg sld
nxx: pjg szs xrg
jzq: dvm
gcj: bkc svg ltz jmn
bqz: sfc
snp: jbk rxb jgn kpr
gmr: qdn
jtf: vnk fxm xkm ckb
vrc: lrz lfp vmr nvn
jrr: tnh vvv
gbj: zfk hcp
czr: vnp
crc: vkr ppj ndm
vfh: sjs qsr sxp
bqc: kbc
xkc: rms dmp pbm qnr gqv knn
jgr: dpm mnd
jml: nng
vxv: frr jpg jpv bsx qnk cgx jrn
cfb: xfp stq mtd
hdn: dhn prf slp ptp rtk rjd
crr: nzs djt lgb fld vpp
mzm: rhk jkm ksv
shn: fkc zsz zdf zjg
cgx: nnq sjf
zhl: ppj
gmg: scq gfl jzh
nnx: klf rzl rlv crs
hgd: hvt
tcq: qbs khp gdh
jfx: gkt pzr zqz xbp
cjp: hvt
jbr: jxs xls gxp
skj: jnm rds zmc
qfg: qnr gkd
qdv: xgd mjz jtk ttg
dhx: frr tgm vfc ntz
ztc: gfp lgk zbv rql
xdc: pbc
tqh: zxf jfl dxz hcp
mmt: ndm gfl pjk lsj
ttg: zts mjn kmc
shf: mlp ppt hrf
dds: vhv tfk
zhm: xdb djf kjb dbf
tbr: jxc qxc zjk mdz
hxd: zcc lmn fvn hgd
bdf: lsz rrs ghr
tbd: zft
xph: vvb zml jgd pqx plc
xtj: nnq cdn slm ffp rgl
ckf: blx
lvx: jml ktp lhn mdz
kmg: hgc mmc vfh gcj
jmn: zfk
ncx: ccz tnh znj
kzp: lsj xjs blz nqk
ngx: mtd sgt dsr
nrg: bdf csn jkv pgl
fhs: vdx rzl pnb mgv mcv
zfq: vhv hdl sdj bbl pvj
hgc: dpm kmm
xps: htk jpg lrk
lck: jfr
zdq: cql rxq kmn kvh ndc
czk: mlq ddc vnl
pfr: fkj kvv jfr jlq ccm
dvh: gjq rdv kbl nbk qlm
vpv: bcj tqs kjl
dnz: xpl ldq hrp
qlk: kjm vrk jxz vkv
kpr: dhc
ldn: kxv rst
rmj: kct lst nsk slk
lvj: psz glv bzn
mlq: vzb cdk
prj: pfz vld ztj jfd
qrc: sgt vkr vgb stn pph
dtz: knm kxf jlg rft
vfz: lhn zgq jzh jml
qvl: xch
pvx: dtg qcl srg
lzd: xlq xgl bfj zdf
hrt: rzl pjg gbh fcx
tgh: hgc jnm
pdr: vsp tcq kjf
sls: npt
gnv: krn
cpz: vgg xnf vjt ftn
nrd: hfl ldj fqc
rhf: njh bzv kqn
sfc: cjf
kcq: rqm clr bfq xkm
xmd: hzz dzq fmc sdb
ckq: crq
rnc: hfl gsz vgv srg
vjg: cdf hdl mnl
lxc: xhx vgm lxd xqz
pbm: nrf
zml: bzv
rdv: mnl
vzb: nsj
jdd: mxn sjs crr hfl
ffp: nck knn
zvr: fzb hds tpz
pxq: dhc gdh
sjs: nrn
gdj: kfh psz zgn
kkz: gzg
qdx: hvr mnr
nmv: dzp cdk rrt qrs
pld: ccj clt drp nzc gkr
ngb: vxd cvh
hxl: mjz fxt tqm nbd
qkc: lfp
sfm: vgl dfg zls frs
fjj: zhl vmk trs
svh: qzj
llz: hxp psj sth tlt
sgt: fmg hhn
tlj: xsj vfj zxq srr
nrs: cmh fmf hnc hfp
kgh: nbk jvp
xvc: lxx vgq
hkx: mpl gvr znx fqs
xsm: tqr msf jcr
hms: czf
qxk: cfp vhv fzb
pgz: kdf vgq rgq mdq
tkc: rsj rcf
cvh: zds
sxl: hrb hqc
lrz: vcz qzd rgm lfj lck
smz: pkf
jbk: jfk tgm fzt
zjj: mxd
cmb: pqn rfb
kjz: njf jsc
nnp: zfk ffp rsj cbd
bbf: nnj mxj cbn hmf
sgq: pmx gnh vmr tkq
bzp: tkc hvr jkf
dcv: brj snm
ztj: dvc vmr
ztz: jml zhl
fvv: nfx vhs cdk
vrt: jlk
snm: jhp
rhk: hzz
gvr: dgz pnc
lrq: pfs
nhv: pbm psp
mcn: xfp gcj
vhx: gpq pbg fzq hnx
ltn: szr
fvj: tcx pmk
fzm: zpd gzz lfj tkk
lfd: rhx msr
msh: nsc qjv frt
mxj: smq zsj zxv
zlr: jzh brv ghv fhv
tvz: bfq gzg hlh
xrc: pkt qbj mqb sgj mzb
nxl: jtg kxs fhp
ntf: mvf jvp
mbc: qcm
rcv: hvv bzd mtb
sjf: rvm
lbs: dds vlr zsc znf
qxt: lfj bjj psj nhc
rtl: jlq
znx: fql
qnc: xnp fzz qcs
qvg: xrg cfp csc pcq dgz
fcf: cxj
mkf: dtk fbd
pxh: vhs
xqz: ckr cdr sdz
mbl: rhk
trn: ckz
cpd: lbg msr njf
cgg: grd fkr pvl
qjb: qzs zzs std vsj
kpz: mls pph nsq sbg flz
pcr: gqk kqn qjg trt
vdf: ksc pvx pzq npb lcd
zhc: lrk sfg pxz
bnx: gqk
gqj: bls cqz spr qxz
bjd: znj qks bjj
dml: vgm
hvp: jfk
ndz: qsl
fbv: tfq brr
xjt: mmj fxv
tdd: nmc mzh jzz
hvx: xhx djr
lcq: jfl
kvh: hdl cmb dzc
rtk: btg ssx
svr: jjv crt
nbs: rvm zgx lbg
xkm: bqx svf
prl: tsm xrg jzq nxx
gcr: xbb
kxd: jpv rjp
vsp: kxd zjg frr
mhp: lst tqj jvg
glm: szs lkp rlv bjz
jxc: zgn tfk
hkh: zhq krs ldn
bkq: cjk jhs msr pmh
qst: ltn mbl scn fsf sfc qts
dmx: cmh jzl
sbq: kxs kbq vjt dzv
zkh: lbq jgf
rqn: cjp jsc
tbk: qdx
gdk: glv xln jqk jvt
tgd: hdl
djg: fqh kfh dhr bcj
pcq: mlp scm
nsq: lrj zls vgl
zqh: bgh dlk vzb
fhl: ptc ffk fds xhk
zdg: kxv fds fsm pbg
fll: cdk
vtf: mnd ckf hzz
rsk: xgd hjk snm
jcn: qkt pxq
plg: tsg
xfx: vnp gqh dvc dhc
fgx: bpq sgb
lrj: ndg ptp
nsc: klf dtb
vvg: txv lgn djs
sdz: lzz mqb
gmh: dxb
znf: lll vhl
drl: nnz qqb jlk
nnj: glq
kxx: csc bgv
vsg: tmn jqr xhx
rcr: dcg mzh qkt
lgk: kjz
jgn: qkg gdh
qcr: ccp sgj dnz dxb
fxt: blb jvt nzp
nlz: pxv trf nvp
vkr: klf fnp
dsm: nrj ckq jkv bqc
snx: lft cvd
zgq: fvg fgg
pdn: hds gvr
ftl: rvk nbk xsm
tlk: vtf trs bcf msh lvr
btv: zds kpr bls
gfm: snz
lcb: plf
rpl: mmv pcz
xrg: qbp
crz: qts hrc nsj zmn
sxp: vdq
smn: mvf lgc txd bjq
knn: tkd
rxh: qnc mfx tkc
qjg: slj vhl
hvm: grd tcx djl dpl nnq
rsf: qnr krs
hmf: lfn tls
smb: pnx xdb
xvn: pmx qkg
rrt: mlr
htq: gkj dxb bjj hvr zxf
htx: vbf lfj qcs khp
fpr: tmf fnb fll bjq zmd ckj
sqc: jnm kcn
sgj: lbg
hgr: fbv dnq vbf
rxd: zjb krq qrq
fbd: mnr lcg
qnq: lcg cxz
mgk: jgf bhd cmd vvv
hrd: vrg xdc ndn
tjb: pkf dqj rht nlz chp klq gft lbt
bbl: xrx zmc
vnh: vct kjz cbr
pxt: ggs glv
lfp: fkc jpl
djf: cbn hmf xnh
fzq: pmx
cjd: fxg nrf smz gcz
jlg: kxv zbv
grq: cvd fhj sls
tnp: pqn qxc bjr cfv kmm gfm
rjj: zfx jqk
qbp: pqn vgl
rfq: zjk rfb gvr
fsf: ljk
bzr: jpg gnh tls
gqv: rsf gqh fzq
zgm: lzc vxb bqc jcn
zrr: cmd jhs dnl sth
tfp: mjg bqz zgb
gtz: jfk pxv fcf
lml: qcm
sdj: hdl
zdf: qbs
bnk: bqz txd
rbr: zsz lmx lvs jzd dnq
djr: fxg
ptd: fkn mfx
nfn: bcf zqz
vxz: znj plg vkv hgd xhx rmp
fvd: zng hlh
zbh: jxs kxx bkc
lqq: vxb gpq kjr
ssq: jzq cmh cfp mnd
rkl: hqc qks nnj
clk: ghv vhv
hdk: pnk pcz kpp
dpc: nsj ckb
mdz: fmg
jlb: rcd smz xvc
dvm: jqk fbn
zkx: ltz
trt: tgd jtg mgn
jgv: hcx msh zrt clt
csh: ckq ktq ftp
qvx: qvl nvs pxv gfz
ndg: thf
scm: xbt jjv
vld: bxb
hbs: nsk grd qkd trn fqh
kff: vgm
jgg: qkc rrs pxv
tgb: gxp dzv zng
hcp: gdh
kfd: vtq zdh pzl kpp dmz
ggk: xks sst xln
xfs: lvr nrn snm ndr
mzb: gqj hvc
bzs: csb vzb sdj dbx
rdj: gcr ksc crc scn
lxl: gpx
ksv: qsr vgg
xfm: ctk qkc mbh
spk: cln dzq hfr rff
xtz: rcv xmv vtq fhp
qpm: fjj lcb kph fvv ckb
ldd: szb ftm tqr vhs
jkv: hmn
pxx: sgb trn ftm
rdg: sfd rcd zvq cdn
mls: blx gmr
tsm: mmj ndz
zqf: frm jpg gmz jzs
vzh: qrs ptp
kzx: gtz sls txt jcn mkx
fvn: jtd cfk
prg: njx zvq tlt
hds: qrs
szs: rtk srn
scn: cgd ftm
pvk: dps vqr
dxq: pbg rxd ndn
dmp: nbs hft
jhd: fzt qnr qnq bkq
xqk: hzr fcs
fqc: svg
ddc: smk
sbg: ltn bgv
pdt: zls qcm
fcs: sld
cbd: zxj lck gcn tmn pkf
grb: mxx zdh xls fbm dtb
gkr: bqx jfx plf
rjd: lgf qcl vpp
chp: glq mlc
rpp: kcn bbz
dxz: csn lbf
zpd: vgm fvj
rgq: nmc
qrh: hkh rql
ztt: lgk jks xch fcp
prh: zfk
bfq: btg
vxs: zjc lgc tbr pxt
rcc: lcd kqn vkr dzp fvd
fcj: gmr pdn fsf bnx
kqp: hvx msb xjd vdr
bjv: dft nxj lkp svf bbz
grv: lxx
mpf: bzn zjk
nck: lrq jpl
pbg: lfz
ktf: blx ckz
vdr: vrt lzz pjq lbt
pss: vjt mmc rhk
rcp: ntz tvs ndn
srr: spp nbd
nzc: dtb
xtv: zgb ggs fql nxl
qkd: nfp fbn cgd clk
kfg: xhf jkf tdd bbd
rln: kqp tht bhc vgf
qmg: lft cck
qcs: ltc
tlc: bzf pgl jrc fkj
tpv: vvv jkh krq
fld: vsv bcj kcn
tpx: plc zmm skj gmg xbt
bqx: qpd dcn
tjz: pcl zfk xvn rnq
mqb: kxv
svl: brr qxz xkq
tgl: vfc lmm rss qjq
crt: fvg vqc fmc
xhf: ltc
jvp: fgg
drp: djt
qgv: gcz vsj zcv fgh hnx
kjm: ktq
hrk: nbk lfg
fxq: kfp
smq: nqv pfs bqc zgp
nvx: tzx kmn lvr tgh kvh rrf
hdd: bjq mdd pss
khq: bgn rrs
bfd: nlj vrg bpf jgf
btg: qpd
mpl: vcb qbp pdt lfg
bpz: cvh xlq sld jtd
mgd: znx kct cfb ckb
gft: gcz ctk
sfl: flz frt ppt jjv
cxf: vld tkq vmt vrk
mff: vpp dcn vcb vpg
ljk: cln fmc
pmn: ctk kdc rms
phs: jtk lgc zgq lxv
mdd: kbx mpv zjk lnb
hgg: lnf vxd hft
fct: zmd nxj fmc
rrf: ppj
hdj: krn
fnp: glv qzh
gzz: zdf
fqk: lxl bzv hnc hrk nzd sdj
hvf: flf jmn ltn lll
xbt: vnz
jkh: gnh
djs: xsv fcs
rnh: jhp
ddj: fcb krs qvl rjp
vhh: lrq std vmr nnq
rss: cvh vrn btv
kqc: gfm frt fxs vhs
glv: ncb
zxq: kfr
jdp: jmn lml nqp vfj
pjg: trs pvl
drm: vtq glv
svt: fsm pgl
kgc: kpr dmp gnv
